#########D##
# #    #   #
# #    #   #
# #### #   #
#    # #   #
###  # #   #
# #  #     #
# #  ###   #
#      ##  #
###### #   #
#      ##  #
#      #   #
#      #   #
###### #   #
# ##   #   #
# ##   ##D##
#          #
############