######D#####
#    #     #
#    #     #
#    #     #
#          #
#          #
#          #
#          #
#          #
#          #
#          #
#          #
#          #
###        #
#          #
#          #
#          #
############